111111111111111111111
1C1000000010000010001
1C1110111010111011101
10000010C010001010101
1010111C1111101010111
101000100000101000101
100010110010101111101
101010000P00101000101
101111101011111010101
1000E0001000000010001
111111111111111111111
