1111111111111111111111111111111
10000010E1C00000000000000100001
10010000110000000000000000000C1
11010P000000000000CCCCCCC111111
100100100100C000000000000000001
1011000001000000000C00000000001
10C10000000000000000000000000C1
1111111111111111111111111111111
